{
  "header":{
    "author":"mick",
    "version":"1.0.0"
  },
  "map":{
    "tilesize":64,
    "theme":"default",
    "width":10,
    "height":10,
    "data":[
      1,1,1,1,1,1,1,1,1,1,
      1,0,0,0,0,0,0,0,3,1,
      1,0,0,0,0,0,0,0,0,1,
      1,0,0,1,1,1,0,0,0,1,
      1,0,0,1,0,0,0,0,0,1,
      1,0,0,1,0,0,0,0,0,1,
      1,0,0,1,0,0,0,0,0,1,
      1,0,2,0,0,0,0,0,0,1,
      1,0,0,0,0,0,0,0,0,1,
      1,1,1,1,1,1,1,1,1,1
    ]
  }
}